{{00,00,00,00,00,00,00,00,00,00,00,00,00,00,00,00,00,00,00,00,00,00,00,00,00,00,00,00,00,00,00,00,00,00,00,00,00,00,00,00,00,00,00,00,00,00,00,00,00,00,00,00,00,00,00,00,00,00,00,00,00,00,00,00,00,00,00,00,00,00},
 {00,00,00,00,00,00,00,00,00,00,00,00,00,00,00,00,00,00,00,00,00,00,00,00,00,00,00,00,00,00,00,00,00,00,00,00,00,00,00,00,00,00,00,00,00,00,00,00,00,00,00,00,00,00,00,00,00,00,00,00,00,00,00,00,00,00,00,00,00,00},
 {00,00,00,00,00,00,00,00,00,00,00,00,00,00,00,00,00,00,00,00,00,00,00,00,00,00,00,00,00,00,00,00,00,00,00,00,00,00,00,00,00,00,00,00,00,00,00,00,00,00,00,00,00,00,00,00,00,00,00,00,00,00,00,00,00,00,00,00,00,00},
 {00,00,00,00,00,00,00,00,00,00,00,00,00,00,00,00,00,00,00,00,00,00,00,00,00,00,00,00,00,00,00,00,00,00,00,00,00,00,00,00,00,00,00,00,00,00,00,00,00,00,00,00,00,00,00,00,00,00,00,00,00,00,00,00,00,00,00,00,00,00},
 {00,00,00,00,00,00,00,00,00,00,00,00,00,00,00,00,00,00,00,00,00,00,00,00,00,00,00,00,00,00,00,00,00,00,00,00,00,00,00,00,00,00,00,00,00,00,00,00,00,00,00,00,00,00,00,00,00,00,00,00,00,00,00,00,00,00,00,00,00,00},
 {00,00,00,00,00,00,00,00,00,00,00,00,00,00,00,00,00,00,00,00,00,00,00,00,00,00,00,00,00,00,00,00,00,00,00,00,00,00,00,00,00,00,00,00,00,00,00,00,00,00,00,00,00,00,00,00,00,00,00,00,00,00,00,00,00,00,00,00,00,00},
 {00,00,00,00,00,00,00,00,00,00,00,00,00,00,00,00,00,00,00,00,00,00,00,00,00,00,00,00,00,00,00,00,00,00,00,00,00,00,00,00,00,00,00,00,00,00,00,00,00,00,00,00,00,00,00,00,00,00,00,00,00,00,00,00,00,00,00,00,00,00},
 {00,00,00,00,00,00,07, 8,00,00,00,00,00,00,00,00,00,00,00,00,00,00,00,00,00,00,00,00,00,00,00,00,00,00,00,00,00,00,00,00,00,00,00,00,00,00,00,00,00,00,00,00,00,00,00,00,00,00,00,00,00,00,00,00,00,00,00,00,00,00},
 {00,00,00,00,00,00,17,18,00,00,00,00,00,00,00,00,00,00,00,00,00,00,00,00,00,00,00,00,00,00,00,00,00,00,00,00,00,00,00,00,00,00,00,00,00,00,00,00,00,00,00,00,00,00,00,00,00,00,00,00,00,00,00,00,00,00,00,00,00,00},
 {00,00,00,00,00,00,27,28,00,00,00,00,00,00,00,00,00,00,00,00,00,00,00,00,00,01,02,02,04,05,02,02,02,02,02,02,02,02,04,05,03,00,00,00,00,00,00,00,00,00,00,00,00,00,00,00,00,00,00,00,00,00,00,00,00,00,00,00,00,00},
 {00,00,00,00,00,00,37,38,00,00,00,00,00,00,00,00,00,00,00,00,00,00,00,00,00,00,00,00,24,25,00,00,00,00,00,00,00,00,24,25,00,00,00,00,00,00,00,01,02,02,04,05,02,03,00,00,00,00,00,00,00,00,00,00,00,00,00,00,00,00},
 {02,02,02,02,02,02,02,02,03,00,00,00,00,00,00,00,00,00,00,00,00,00,00,00,00,00,00,00,14,15,00,00,00,00,00,00,00,00,14,15,00,00,00,00,00,00,00,00,00,00,24,25,11,13,00,00,00,00,00,00,00,00,01,02,02,02,02,02,02,02},
 {12,12,12,12,12,12,12,12,13,00,00,00,00,00,00,00,00,00,00,00,00,00,00,00,00,00,00,00,24,25,00,00,00,00,00,00,00,00,24,25,00,00,00,00,00,00,00,00,00,00,14,15,11,13,00,00,00,00,00,00,00,01,12,12,12,12,12,12,12,12},
 {12,12,12,12,12,12,12,12,13,00,00,00,00,00,00,00,00,00,00,00,00,00,00,00,00,00,00,00,14,15,00,00,00,00,00,00,00,00,14,15,00,00,00,00,00,00,00,00,00,00,24,25,11,12,02,02,02,03,00,00,00,11,12,12,12,12,12,12,12,12},
 {12,12,12,12,12,12,12,12,12,02,02,02,02,02,02,04,05,02,02,02,02,02,02,02,02,02,02,02,02,02,03,00,00,00,00,00,00,01,02,02,03,00,00,01,02,02,02,03,00,00,14,15,11,13,00,00,00,00,00,00,00,11,12,12,12,12,12,12,12,12},
 {12,12,12,12,12,12,12,12,13,00,00,00,00,00,00,14,15,00,00,00,00,00,00,00,00,00,00,00,00,00,00,00,00,00,00,00,00,00,00,00,00,00,00,00,00,00,00,00,00,00,24,25,11,13,00,00,00,00,00,00,00,11,12,12,12,12,12,12,12,12},
 {12,12,12,12,12,12,12,12,13,00,00,00,00,00,00,24,25,00,00,00,00,00,00,00,00,00,00,00,00,00,00,00,00,00,00,00,00,00,00,00,00,00,00,00,00,00,00,00,00,00,14,15,11,13,00,00,00,00,00,00,00,11,12,12,12,12,12,12,12,12},
 {12,12,12,12,12,12,12,12,13,00,00,00,00,00,00,14,15,00,00,00,00,00,00,00,00,00,00,00,00,00,00,00,00,00,00,00,00,00,00,00,00,00,00,00,00,00,00,00,00,00,24,25,11,13,00,00,00,00,00,00,00,11,12,12,12,12,12,12,12,12},
 {12,12,12,12,12,12,12,12,12,02,02,04,05,02,02,02,02,02,02,02,02,02,03,00,00,00,00,00,00,00,00,00,00,00,00,00,00,00,00,00,00,01,02,04,05,03,00,00,00,00,14,15,11,13,00,00,00,00,00,00,00,11,12,12,12,12,12,12,12,12},
 {12,12,12,12,12,12,12,12,13,00,00,14,15,00,00,00,00,00,00,00,00,00,00,00,00,00,00,00,00,00,00,00,00,00,00,00,00,00,00,00,00,00,00,14,15,00,00,00,00,00,24,25,11,13,00,00,00,00,00,00,00,11,12,12,12,12,12,12,12,12},
 {12,12,12,12,12,12,12,12,13,00,00,24,25,00,00,00,00,00,00,00,00,00,00,00,00,00,00,00,00,00,00,00,00,00,00,00,00,00,00,00,00,00,00,24,25,00,00,00,00,00,14,15,11,13,00,00,00,00,00,00,00,11,12,12,12,12,12,12,12,12},
 {12,12,12,12,12,12,12,12,13,00,00,14,15,00,00,00,00,00,00,00,00,00,00,00,00,00,00,00,00,00,00,00,00,00,00,00,00,00,00,00,00,00,00,14,15,00,00,00,00,00,24,25,11,13,00,00,01,02,02,02,02,12,12,12,12,12,12,12,12,12},
 {12,12,12,12,12,12,12,12,13,00,00,24,25,00,00,00,00,00,00,00,00,00,00,01,02,02,02,02,02,02,02,02,02,02,03,00,00,00,00,00,00,00,00,24,25,00,00,00,00,00,14,15,21,23,00,00,00,00,00,00,00,11,12,12,12,12,12,12,12,12},
 {12,12,12,12,12,12,12,12,13,00,00,14,15,00,00,00,00,00,00,00,00,00,00,00,00,00,00,00,00,00,00,00,00,00,00,00,00,00,00,00,00,00,01,02,02,02,02,02,02,02,02,02,02,02,00,00,00,00,00,00,00,11,12,12,12,12,12,12,12,12},
 {12,12,12,12,12,12,12,12,13,00,01,02,02,02,04,05,02,03,00,00,00,00,00,00,00,00,00,00,00,00,00,00,00,00,00,00,00,00,00,00,00,00,00,00,00,00,00,00,00,00,00,00,00,00,00,00,00,00,00,00,00,11,12,12,12,12,12,12,12,12},
 {12,12,12,12,12,12,12,12,13,00,00,00,00,00,14,15,00,00,00,00,00,00,00,00,00,00,00,00,00,00,00,00,00,00,00,00,00,00,00,00,00,00,00,00,00,00,00,00,00,00,00,00,00,00,00,00,00,00,00,00,00,11,12,12,12,12,12,12,12,12},
 {12,12,12,12,12,12,12,12,13,00,00,00,00,00,24,25,00,00,00,00,00,00,00,00,00,00,00,00,00,00,00,00,00,00,00,00,00,00,00,00,00,00,00,00,00,00,00,00,00,00,00,00,00,00,00,00,00,00,00,00,00,11,12,12,12,12,12,12,12,12},
 {12,12,12,12,12,12,12,12,13,00,00,00,00,00,14,15,00,00,00,00,00,00,00,00,00,00,00,00,00,00,00,00,00,00,00,00,00,00,00,00,00,00,00,00,00,00,00,00,00,00,00,00,00,00,00,00,00,00,00,00,00,11,12,12,12,12,12,12,12,12},
 {12,12,12,12,12,12,12,12,12,02,02,02,02,02,02,02,02,02,02,02,02,02,03,00,00,00,00,00,00,00,01,02,02,02,02,02,02,02,03,00,00,01,02,03,00,00,00,00,01,02,02,02,02,02,02,02,02,02,02,02,02,12,12,12,12,12,12,12,12,12},
 {12,12,12,12,12,12,12,12,12,34,34,34,34,34,34,34,34,34,34,34,34,34,45,06,06,06,06,06,06,06,44,34,34,34,34,34,34,34,45,06,06,44,34,45,06,06,06,06,44,34,34,34,34,34,34,34,34,34,34,34,34,12,12,12,12,12,12,12,12,12},
 {12,12,12,12,12,12,12,12,12,16,16,16,16,16,16,16,16,16,16,16,16,16,16,16,16,16,16,16,16,16,16,16,16,16,16,16,16,16,16,16,16,16,16,16,16,16,16,16,16,16,16,16,16,16,16,16,16,16,16,16,16,12,12,12,12,12,12,12,12,12},
 {12,12,12,12,12,12,12,12,12,16,16,16,16,16,16,16,16,16,16,16,16,16,16,16,16,16,16,16,16,16,16,16,16,16,16,16,16,16,16,16,16,16,16,16,16,16,16,16,16,16,16,16,16,16,16,16,16,16,16,16,16,12,12,12,12,12,12,12,12,12},
 {12,12,12,12,12,12,12,12,12,16,16,16,16,16,16,16,16,16,16,16,16,16,16,16,16,16,16,16,16,16,16,16,16,16,16,16,16,16,16,16,16,16,16,16,16,16,16,16,16,16,16,16,16,16,16,16,16,16,16,16,16,12,12,12,12,12,12,12,12,12},
 {12,12,12,12,12,12,12,12,12,12,12,12,12,12,12,12,12,12,12,12,12,12,12,12,12,12,12,12,12,12,12,12,12,12,12,12,12,12,12,12,12,12,12,12,12,12,12,12,12,12,12,12,12,12,12,12,12,12,12,12,12,12,12,12,12,12,12,12,12,12},
 {59,59,59,59,59,59,59,59,59,59,59,59,59,59,59,59,59,59,59,59,59,59,59,59,59,59,59,59,59,59,59,59,59,59,59,59,59,59,59,59,59,59,59,59,59,59,59,59,59,59,59,59,59,59,59,59,59,59,59,59,59,59,59,59,59,59,59,59,59,59},
 {59,59,59,59,59,59,59,59,59,59,59,59,59,59,59,59,59,59,59,59,59,59,59,59,59,59,59,59,59,59,59,59,59,59,59,59,59,59,59,59,59,59,59,59,59,59,59,59,59,59,59,59,59,59,59,59,59,59,59,59,59,59,59,59,59,59,59,59,59,59},
 {59,59,59,59,59,59,59,59,59,59,59,59,59,59,59,59,59,59,59,59,59,59,59,59,59,59,59,59,59,59,59,59,59,59,59,59,59,59,59,59,59,59,59,59,59,59,59,59,59,59,59,59,59,59,59,59,59,59,59,59,59,59,59,59,59,59,59,59,59,59},
 {59,59,59,59,59,59,59,59,59,59,59,59,59,59,59,59,59,59,59,59,59,59,59,59,59,59,59,59,59,59,59,59,59,59,59,59,59,59,59,59,59,59,59,59,59,59,59,59,59,59,59,59,59,59,59,59,59,59,59,59,59,59,59,59,59,59,59,59,59,59},
 {59,59,59,59,59,59,59,59,59,59,59,59,59,59,59,59,59,59,59,59,59,59,59,59,59,59,59,59,59,59,59,59,59,59,59,59,59,59,59,59,59,59,59,59,59,59,59,59,59,59,59,59,59,59,59,59,59,59,59,59,59,59,59,59,59,59,59,59,59,59},
 {59,59,59,59,59,59,59,59,59,59,59,59,59,59,59,59,59,59,59,59,59,59,59,59,59,59,59,59,59,59,59,59,59,59,59,59,59,59,59,59,59,59,59,59,59,59,59,59,59,59,59,59,59,59,59,59,59,59,59,59,59,59,59,59,59,59,59,59,59,59}};