{{00,00,00,00,00,00,00,00,00,00,00,00,00,00,00,00,00,00,00,00,00,00,00,00,00,00,00,00,00,00,00,00,00,00,00,00,00,00,00,00,00,00,00,00,00,00,00,00,00,00,00,00,00,00,00,00,00,00,00,00,00,00,00,00,00,00,00,00,00,00},
 {00,00,00,00,00,00,00,00,00,00,00,00,00,00,00,00,00,00,00,00,00,00,00,00,00,00,00,00,00,00,00,00,00,00,00,00,00,00,00,00,00,00,00,00,00,00,00,00,00,00,00,00,00,00,00,00,00,00,00,00,00,00,00,00,00,00,00,00,00,00},
 {00,00,00,00,00,00,00,00,00,00,00,00,00,00,00,00,00,00,00,00,00,00,00,00,00,00,00,00,00,00,00,00,00,00,00,00,00,00,00,00,00,00,00,00,00,00,00,00,00,00,00,00,00,00,00,00,00,00,00,00,00,00,00,00,00,00,00,00,00,00},
 {00,00,00,00,00,00,00,00,00,00,00,00,00,00,00,00,00,00,00,00,00,00,00,00,00,00,00,00,00,00,00,00,00,00,00,00,00,00,00,00,00,00,00,00,00,00,00,00,00,00,00,00,00,00,00,00,00,00,00,00,00,00,00,00,00,00,00,00,00,00},
 {00,00,00,00,00,00,00,00,00,00,00,00,00,00,00,00,00,00,00,00,00,00,00,00,00,00,00,00,00,00,00,00,00,00,00,00,00,00,00,00,00,00,00,00,00,00,00,00,00,00,00,00,00,00,00,00,00,00,00,00,00,00,00,00,00,00,00,00,00,00},
 {00,00,00,00,00,00,00,00,00,00,00,00,00,00,00,00,00,00,00,00,00,00,00,00,00,00, 9,10,00,00,00,00,00,00,00,00,00,00,00,00,00,00,00,00,00,00,00,00,00,00,00,00,00,00,00,00,00,00,00,00,00,00,00,00,00,00,00,00,00,00},
 {00,00,00,00,00,00,00,00,00,00,00,00,00,00,00,00,00,00,00,00,00,00,00,00,00,00,19,20,00,00,00,00,00,00,00,00,00,00,00,00,00,00,00,00,00,00,00,00,00,00,00,00,00,00,00,00,00,00,00,00,00,00,00,00,00,00,00,00,00,00},
 {00,07, 8,00, 9,10,07, 8,00,00,00,00,00,00,00,00,00,00,00,00,00,00,00,00,00,00,29,30,00,00,00,00,00,00,00,00,00,00,00,00,00,00,00,00,00,00,00,00,00,00,00,00,00,00,00,00,00,00,00,00,00,00,00,00, 7, 8,00,00, 9,10},
 {00,17,18,00,19,20,17,18,00,00,00,00,00,00,00,00,00,00,00,00,00,00,00,00,00,00,39,40,00,00,00,00,00,00,54,58,00,00,00,00,00,00,00,00,00,00,00,00,00,00,00,00,00,00,00,00,00,00,00,00,00,00,00,00,17,18,00,00,19,20},
 {00,27,28,00,29,30,27,28,00,00,00,00,00,00,00,00,00,00,00,00,00,00,00,00,00,01,02,02,04,05,02,02,02,02,02,02,02,02,04,05,03,00,00,00,00,00,00,57,00,00,00,00,48,00,00,00,00,00,00,00,00,00,00,00,27,28,00,00,29,30},
 {00,37,38,00,39,40,37,38,00,00,00,00,00,00,00,00,00,00,00,00,00,00,00,00,00,00,00,00,24,25,00,00,00,00,00,00,00,00,24,25,00,00,00,00,00,00,00,01,02,04,05,02,02,03,00,00,00,00,00,00,00,00,00,00,37,38,00,00,39,40},
 {02,02,02,02,02,02,02,02,03,00,00,00,00,00,00,00,00,00,00,00,00,00,00,00,00,00,00,00,14,15,00,00,00,00,00,00,00,00,14,15,00,00,00,00,00,00,00,00,00,24,25,00,11,13,00,00,00,00,00,00,00,55,01,02,02,02,02,02,02,02},
 {12,12,12,12,12,12,12,12,13,00,00,00,00,00,00,00,00,00,00,00,00,00,00,00,00,00,00,00,24,25,00,00,00,00,00,00,00,00,24,25,00,00,00,00,00,00,00,00,00,14,15,00,11,13,00,00,00,00,00,00,00,01,12,12,12,12,12,12,12,12},
 {12,12,12,12,12,12,12,12,13,00,00,00,00,00,00,00,00,00,00,57,56,58,00,00,00,46,00,00,14,15,54,00,00,00,00,00,00,00,14,15,00,00,00,00,00,49,00,00,00,24,25,00,11,12,02,02,02,03,00,00,00,11,12,12,12,12,12,12,12,12},
 {12,12,12,12,12,12,12,12,12,02,02,02,02,02,02,04,05,02,02,02,02,02,02,02,02,02,02,02,02,02,03,00,00,00,00,00,00,01,02,02,03,00,00,01,02,02,02,03,00,14,15,00,11,13,00,00,00,00,00,00,00,11,12,12,12,12,12,12,12,12},
 {12,12,12,12,12,12,12,12,13,00,00,00,00,00,00,14,15,00,00,00,00,00,00,00,00,00,00,00,00,00,00,00,00,00,00,00,00,00,00,00,00,00,00,00,00,00,00,00,00,24,25,00,11,13,00,00,00,00,00,00,00,11,12,12,12,12,12,12,12,12},
 {12,12,12,12,12,12,12,12,13,00,00,00,00,00,00,24,25,00,00,00,00,00,00,00,00,00,00,00,00,00,00,00,00,00,00,00,00,00,00,00,00,00,00,00,00,00,00,00,00,14,15,00,11,13,00,00,00,00,00,00,00,11,12,12,12,12,12,12,12,12},
 {12,12,12,12,12,12,12,12,13,00,00,00,00,00,00,14,15,00,00,00,54,55,58,00,00,00,00,00,00,00,00,00,00,00,00,00,00,00,00,00,00,00,00,00,00,00,00,00,00,24,25,00,11,13,00,00,00,00,00,00,00,11,12,12,12,12,12,12,12,12},
 {12,12,12,12,12,12,12,12,12,02,02,04,05,02,02,02,02,02,02,02,02,02,03,00,00,00,07, 8,00, 9,10,00,00,00,00,00,00,00,00,00,00,01,02,04,05,03,00,00,00,14,15,00,11,13,00,00,00,00,00,00,00,11,12,12,12,12,12,12,12,12},
 {12,12,12,12,12,12,12,12,13,00,00,14,15,00,00,00,00,00,00,00,00,00,00,00,00,00,17,18,00,19,20,00,00,00,00,00,00,00,00,00,00,00,00,14,15,00,00,00,00,24,25,00,11,13,00,00,00,00,00,00,00,11,12,12,12,12,12,12,12,12},
 {12,12,12,12,12,12,12,12,13,00,00,24,25,00,00,00,00,00,00,00,00,00,00,00,00,00,27,28,00,29,30,00,00,00,00,00,00,00,00,00,00,00,00,24,25,00,00,00,00,14,15,00,11,13,00,00,00,00,00,00,00,11,12,12,12,12,12,12,12,12},
 {12,12,12,12,12,12,12,12,13,00,00,14,15,00,00,00,00,00,00,00,00,00,00,00,00,00,37,38,00,39,40,00,49,00,00,00,00,00,00,00,00,00,00,14,15,00,00,00,00,24,25,00,11,13,00,00,01,02,02,02,02,12,12,12,12,12,12,12,12,12},
 {12,12,12,12,12,12,12,12,13,00,00,24,25,00,00,00,00,00,00,00,00,00,00,01,02,02,02,02,02,02,02,02,02,02,03,00,00,00,00,00,00,00,00,24,25,00,00,00,00,14,15,00,21,23,00,00,00,00,00,00,00,11,12,12,12,12,12,12,12,12},
 {12,12,12,12,12,12,12,12,13,00,00,14,15,00,00,00,00,00,00,00,00,00,00,00,00,00,00,00,00,00,00,00,00,00,00,00,00,00,00,00,00,00,01,02,02,02,02,02,02,02,02,02,02,02,00,00,00,00,00,00,00,11,12,12,12,12,12,12,12,12},
 {12,12,12,12,12,12,12,12,13,00,01,02,02,02,04,05,02,03,00,00,00,00,00,00,00,00,00,00,00,00,00,00,00,00,00,00,00,00,00,00,00,00,00,00,00,00,00,00,00,00,00,00,00,00,00,00,00,00,00,00,00,11,12,12,12,12,12,12,12,12},
 {12,12,12,12,12,12,12,12,13,00,00,00,00,00,14,15,00,00,00,00,00,00,00,00,00,00,00,00,00,00,00,00,00,00,00,00,00,00,00,00,00,00,00,00,00,00,00,00,00,00,00,00,00,00,00,00,00,00,60,60,00,11,12,12,12,12,12,12,12,12},
 {12,12,12,12,12,12,12,12,13,00,00,00,00,00,24,25,00,00,00,00,00,00,00,00,00,00,00,00,00,00,00,00,00,00,00,00,00,00,00,00,00,00,00,00,00,00,00,00,00,00,00,00,00,00,00,00,00,00,60,60,00,11,12,12,12,12,12,12,12,12},
 {12,12,12,12,12,12,12,12,13,47,48,47,00,00,14,15,00,00,00,00,00,49,00,00,00,00,00,00,00,00,00,57,56,00,00,00,57,00,00,00,00,00,54,00,00,00,00,00,00,55,00,00,00,00,00,00,00,00,60,60,00,11,12,12,12,12,12,12,12,12},
 {12,12,12,12,12,12,12,12,12,02,02,02,02,02,02,02,02,02,02,02,02,02,03,00,00,00,00,00,00,00,01,02,02,02,02,02,02,02,03,00,00,01,02,03,00,00,00,00,01,02,02,02,02,02,02,02,02,02,02,02,02,12,12,12,12,12,12,12,12,12},
 {12,12,12,12,12,12,12,12,12,34,34,34,34,34,34,34,34,34,34,34,34,34,45,06,06,06,06,06,06,06,44,34,34,34,34,34,34,34,45,06,06,44,34,45,06,06,06,06,44,34,34,34,34,34,34,34,34,34,34,34,34,12,12,12,12,12,12,12,12,12},
 {12,12,12,12,12,12,12,12,12,16,16,16,16,16,16,16,16,16,16,16,16,16,16,16,16,16,16,16,16,16,16,16,16,16,16,16,16,16,16,16,16,16,16,16,16,16,16,16,16,16,16,16,16,16,16,16,16,16,16,16,16,12,12,12,12,12,12,12,12,12},
 {12,12,12,12,12,12,12,12,12,16,16,16,16,16,16,16,16,16,16,16,16,16,16,16,16,16,16,16,16,16,16,16,16,16,16,16,16,16,16,16,16,16,16,16,16,16,16,16,16,16,16,16,16,16,16,16,16,16,16,16,16,12,12,12,12,12,12,12,12,12},
 {12,12,12,12,12,12,12,12,12,16,16,16,16,16,16,16,16,16,16,16,16,16,16,16,16,16,16,16,16,16,16,16,16,16,16,16,16,16,16,16,16,16,16,16,16,16,16,16,16,16,16,16,16,16,16,16,16,16,16,16,16,12,12,12,12,12,12,12,12,12},
 {12,12,12,12,12,12,12,12,12,12,12,12,12,12,12,12,12,12,12,12,12,12,12,12,12,12,12,12,12,12,12,12,12,12,12,12,12,12,12,12,12,12,12,12,12,12,12,12,12,12,12,12,12,12,12,12,12,12,12,12,12,12,12,12,12,12,12,12,12,12},
 {59,59,59,59,59,59,59,59,59,59,59,59,59,59,59,59,59,59,59,59,59,59,59,59,59,59,59,59,59,59,59,59,59,59,59,59,59,59,59,59,59,59,59,59,59,59,59,59,59,59,59,59,59,59,59,59,59,59,59,59,59,59,59,59,59,59,59,59,59,59},
 {59,59,59,59,59,59,59,59,59,59,59,59,59,59,59,59,59,59,59,59,59,59,59,59,59,59,59,59,59,59,59,59,59,59,59,59,59,59,59,59,59,59,59,59,59,59,59,59,59,59,59,59,59,59,59,59,59,59,59,59,59,59,59,59,59,59,59,59,59,59},
 {59,59,59,59,59,59,59,59,59,59,59,59,59,59,59,59,59,59,59,59,59,59,59,59,59,59,59,59,59,59,59,59,59,59,59,59,59,59,59,59,59,59,59,59,59,59,59,59,59,59,59,59,59,59,59,59,59,59,59,59,59,59,59,59,59,59,59,59,59,59},
 {59,59,59,59,59,59,59,59,59,59,59,59,59,59,59,59,59,59,59,59,59,59,59,59,59,59,59,59,59,59,59,59,59,59,59,59,59,59,59,59,59,59,59,59,59,59,59,59,59,59,59,59,59,59,59,59,59,59,59,59,59,59,59,59,59,59,59,59,59,59},
 {59,59,59,59,59,59,59,59,59,59,59,59,59,59,59,59,59,59,59,59,59,59,59,59,59,59,59,59,59,59,59,59,59,59,59,59,59,59,59,59,59,59,59,59,59,59,59,59,59,59,59,59,59,59,59,59,59,59,59,59,59,59,59,59,59,59,59,59,59,59},
 {59,59,59,59,59,59,59,59,59,59,59,59,59,59,59,59,59,59,59,59,59,59,59,59,59,59,59,59,59,59,59,59,59,59,59,59,59,59,59,59,59,59,59,59,59,59,59,59,59,59,59,59,59,59,59,59,59,59,59,59,59,59,59,59,59,59,59,59,59,59}};